

EA includes/textures/store.png
WE includes/textures/brick.png

C 135, 206, 235

F 140,130,138



NO includes/textures/store.png
SO includes/textures/brick.png



11111111111111111111
1     |     1N1    1
10000010000110100111
1000000000001-100001
10000000000000100001
10001111111111000001
11111111111111111111
