
NO     ./path_to_the_north_texture.png
SO ./path_to_the_south_texture.png
C 99,25,90
F 220,100,80

EA ./path_to_the_east_texture.png
WE ./path_to_the_west_texture.png

111111
10N01
111111