

NO textures/texture-pattern.png
SO textures/texture-pattern.png

C 9,89,09
F 9       ,      9     , 0


EA textures/texture-pattern.png
WE textures/texture-pattern.png



1111111111111111111111111   
1000000000110000000000001
1011000001110000000000001
1001000000000000000000001
1111111110110000011111111100000001
100000000011000001110111111111111
11110111111111011100000010001
11110111111111011101010010001
11000000110101011100000010001
10000000000000000000000000001
10000000000000000101010010001
11000001110101010111011110N0111
11110111 1110101 101111010001
11111111 11111111 11111111111
11111111 1111111 111111111 11



