

NO includes/textures/rock.png
SO includes/textures/rock.png

C 0,0,0

F 255,255,255



EA includes/textures/rock.png
WE includes/textures/rock.png



1111111111111111111111111               
1           N           1     
1000000000111111111111111        
10000000001
10000000001
10000000001
11111111111
